NO ./textures/north.xpm
EA ./textures/east.xpm
WE ./textures/west.xpm
SO ./textures/south.xpm
C 250,30,0
F 250,100,0

1111111111111111111111111
1000000000110000000000001
1011000001110000000000000
100100000000000000000000111111111
1111111110110000011100000000000E1
100000000011000001111111010111111
11110111111111011100000010001
11110111111111011101010010001
11000000110101011100000010001
10000000000000001100000010001
10000000000000001101010010001
1100000111010100111101111000111
11110111 1110101 101111010001
11111111 1111111 111111111111